"filename", "language", "Java", "comment", "blank", "total"
"c:\storage\Eclipse\workspace\CanvasBot\src\net\speedstor\control\Cmd.java", "Java", 131, 1, 13, 145
"c:\storage\Eclipse\workspace\CanvasBot\src\net\speedstor\control\Credentials.java", "Java", 5, 0, 2, 7
"c:\storage\Eclipse\workspace\CanvasBot\src\net\speedstor\control\Log.java", "Java", 58, 0, 19, 77
"c:\storage\Eclipse\workspace\CanvasBot\src\net\speedstor\control\Settings.java", "Java", 24, 2, 10, 36
"c:\storage\Eclipse\workspace\CanvasBot\src\net\speedstor\discussion\CanvasDiscussion.java", "Java", 245, 15, 39, 299
"c:\storage\Eclipse\workspace\CanvasBot\src\net\speedstor\discussion\Discussion.java", "Java", 206, 10, 40, 256
"c:\storage\Eclipse\workspace\CanvasBot\src\net\speedstor\discussion\DiscussionHandler.java", "Java", 61, 0, 14, 75
"c:\storage\Eclipse\workspace\CanvasBot\src\net\speedstor\main\Cache.java", "Java", 100, 9, 14, 123
"c:\storage\Eclipse\workspace\CanvasBot\src\net\speedstor\main\Main.java", "Java", 84, 5, 26, 115
"c:\storage\Eclipse\workspace\CanvasBot\src\net\speedstor\main\ThreadScripts.java", "Java", 48, 2, 10, 60
"c:\storage\Eclipse\workspace\CanvasBot\src\net\speedstor\main\TokenHandler.java", "Java", 166, 14, 34, 214
"c:\storage\Eclipse\workspace\CanvasBot\src\net\speedstor\network\Network.java", "Java", 72, 5, 17, 94
"c:\storage\Eclipse\workspace\CanvasBot\src\net\speedstor\server\APIFunctions.java", "Java", 542, 39, 150, 731
"c:\storage\Eclipse\workspace\CanvasBot\src\net\speedstor\server\APIServer.java", "Java", 63, 3, 13, 79
"c:\storage\Eclipse\workspace\CanvasBot\src\net\speedstor\server\APIServerThread.java", "Java", 211, 18, 29, 258
"c:\storage\Eclipse\workspace\CanvasBot\src\net\speedstor\server\WebServer.java", "Java", 134, 3, 24, 161
"c:\storage\Eclipse\workspace\CanvasBot\src\net\speedstor\websocket\InStream.java", "Java", 210, 19, 56, 285
"c:\storage\Eclipse\workspace\CanvasBot\src\net\speedstor\websocket\OutStream.java", "Java", 170, 22, 42, 234
"c:\storage\Eclipse\workspace\CanvasBot\src\net\speedstor\websocket\WebSocket.java", "Java", 107, 2, 27, 136
"c:\storage\Eclipse\workspace\CanvasBot\src\net\speedstor\websocket\WebSocketHandler.java", "Java", 107, 2, 21, 130
"Total", "-", 2744, 171, 600, 3515